1111111111111111111111111111111111111111111111111111111111111
1CCCCCCC1CCC1CCC1CCCCCCCCC1C1CCC1CCC1CCCCC1C1CCCCC1CCCCCCC1E1
1C111C111C11111C1C111C111C1C111C111C11111C1C1C1C1C111C111C1C1
1CCC1CCCCC1CCCCC1C1CCC1C1CCCCCCCCCCC1CCCCCCC1C1C1C1CCC1CCCCC1
111111111C111C1C1C111C1C1111111C11111C11111111111C1C1C11111C1
1CCC1CCCCC1C1C1C1CCC1CCCCCCC1C1C1CCCCCCCCC1CCC1C1C1C1CCCCC1C1
111C111C111C1C1111111C1C111C1C111C111C111C111C1C1C1111111C1C1
1CCC1C1CCC1C1CCCCC1CCC1C1CCC1CCCCC1CCC1CCCCC1C1C1CCCCC1C1C1C1
111C1C1C111C11111C1C1111111C11111C1C1111111C1C1C1C1C111C111C1
1CCCCCCC1CCC1C1CCCCC1C1CCC1C1C1CCC1CCC1CCC1CCC1CCC1CCC1CCCCC1
111C11111C111C1C11111C111C1C1C1C1111111C11111C1C11111C1C11111
1CCCCCCCCCCC1CCCCC1C1C1CCC1C1CCCCCCCCCCCCCCC1C1C1C1CCCCC1CCC1
1C1C11111C1C111C111C1C1C1C111C1C1C1C111C111111111C1C111C1C1C1
1C1CCCCC1C1C1CCCCC1C1CCC1CCC1C1C1C1C1CCCCC1C1CCCCC1C1CCC1C1C1
1C111111111C11111C1C111C1111111111111C1C1C1C1C1C111C11111C1C1
1CCCCC1CCC1C1CCCCCCC1C1C1CCCCCCCCCCC1C1C1CCC1C1CCCCCCC1C1C1C1
1C1111111C1C1C111C111C1C111C1C111C111C1C1C11111111111C1C1C111
1CCC1CCCCCCCCCCC1CCCCCCCCC1C1CCC1C1CCC1C1CCCCC1CCC1C1C1CCCCC1
111C111111111C111C111C111C1C111111111C1C111C1C1C1C1C1C111C111
1C1C1CCC1CCCCCCC1C1CCC1C1CCC1CCCCCCCCC1C1CCC1C1C1CCCCCCCCCCC1
1C1C1C1111111C11111C1C1C111C1111111C11111C111C1C1111111C11111
1CCCCCCCCC1CCCCC1CCC1C1CCCCCCCCC1CCC1C1CCCCC1C1CCC1C1C1CCCCC1
1C111111111C1111111111111C11111C1C111C11111C111C111C1C111C111
1CCCCC1CCC1C1C1C1CCCCC1CCC1CCC1CCCCC1C1CCCCCCC1CCCCC1CCCCC1C1
1C1C1C111C111C1C1C11111C1C1C111C1C1C1C1C1C1C111C11111111111C1
1C1C1C1CCCCCCCCC1CCCCCCC1C1C1CCC1C1CCC1C1C1CCCCC1CCCCCCC1CCC1
1111111C111C1111111C1111111C111C1C1C11111C11111C1C11111C111C1
1P1CCCCC1C1CCC1CCCCCCCCCCCCCCC1C1C1C1CCC1CCCCC1C1CCC1CCCCCCC1
1C1C1C111C111C1C1C111111111C1C1C11111C11111111111C1C111C11111
1C1C1CCC1CCC1CCC1CCCCCCC1CCC1C1CCCCCCC1C1CCCCC1CCC1C1C1CCC1C1
1C1C1C111C11111111111111111C1111111C111C1C111C11111C1C1C111C1
1C1C1CCC1CCCCC1C1CCCCC1CCC1C1C1CCCCC1CCC1CCC1C1C1CCC1CCCCC1C1
1C1C111C1C111C1C11111C1C1C111C111C1C1C1C1C111C1C1C111111111C1
1C1C1CCC1CCC1CCC1CCCCCCC1CCCCCCC1C1CCC1C1CCC1C1CCCCCCCCCCCCC1
1C111C111111111C111C1C11111C1C111C111C111C1C11111C111111111C1
1CCC1CCCCC1CCC1C1CCC1C1CCC1C1C1CCCCC1C1C1C1C1C1CCC1CCC1C1CCC1
1C111C11111C1C1C1C1C11111C111C1C111C111C111C1C111C1C111C1C111
1CCCCC1CCCCC1CCC1C1CCCCC1CCCCC1C1CCCCCCCCCCC1CCCCC1C1C1CCC1C1
1C111C1C1111111C111C11111C1C1C1C111C11111C11111C1C1C1C111C1C1
1CCC1CCCCC1CCCCC1CCCCC1CCC1C1CCC1CCCCCCC1CCCCCCC1CCCCCCC1CCC1
1111111111111111111111111111111111111111111111111111111111111
