111111111111
10C1000000X1
100001C10111
111101110111
1P0001E000C1
111111111111
