11111111111111111111111111111111
1P00100001100C11111C0000000000C1
11101011001001111C111C111C111111
1000E00110001111E0110011100000C1
111111111001111E0010001111111101
1000001100111100000000111000C101
101C101001111E000010011100101101
101C10001111C0011000111001101101
10111001111XC0000001110011101101
1E000011111111111C11100000101101
11110111111111111C11100010101101
11C10011111111111C11100110101101
1E0000000000C1111C111011101C00C1
11111111111011111C1C001C00111111
1C000010E0000111111C0011011CCCE1
1C1110001111C1111C110110000C11C1
1CCC1C100000000000000C1C111CCCE1
11111111111111111111111111111111
