1111111111111111111
100000000000010C1C1
1011111111010101101
101C001000000000101
1011101001111110101
100P100E00C1C0000X1
1111111111111111111
