111111111
1P00001E1
101111111
101C00001
101011111
1000000C1
111011111
1C00000X1
111111111
