111111111111111111111
1P0101010101010101001
110000000000000000011
100000000000000000001
110000000000000000011
100000000000000000001
110000000000000000011
100000000000000000001
11000000EEEEE00000011
10000000EEEEE00000001
11000000EECEE00000001
11000000EEEEE00000011
10000000EEEEE00000001
110000000000000000011
100000000000000000001
110000000000000000011
100000000000000000001
110000000000000000011
1001010101010101010X1
111111111111111111111