11111111111111111111111111111
1EEEEEEEEEEEEEEEEEEEEEEEEEEE1
1EEEEEEEEEEEEEEEEEEEEEEEEEEE1
1EEEEEEEEEEEEEEEEEEEEEEEEEEE1
1EEEEEEEEEEEEEEEEEEEEEEEEEEE1
1EEEEEEEEEEEEEEEEEEEEEEEEEEE1
1EEEEEEEEEEEEEEEEEEEEEEEEEEE1
1EEEEEEEEEEEEEEEEEEEEEEEEEEE1
1EEEEEEEEEEEEEEEEEEEEEEEEEEE1
1EEEEEEEEEEEEEEEEEEEEEEEEEEE1
1EEEEEEEEEEEEEEEEEEEEEEEEEEE1
1EEEEEEEEEEEEEEEEEEEEEEEEEEE1
1EEEEEEEEEEEEEEEEEEEEEEEEEEE1
1EEEEEEEEEEEEEEEEEEEEEEEEEEE1
1EEEEEEEEEEE11111EEEEEEEEEEE1
1EEEEEEEEEEE1PCX1EEEEEEEEEEE1
1EEEEEEEEEEE11111EEEEEEEEEEE1
1EEEEEEEEEEEEEEEEEEEEEEEEEEE1
1EEEEEEEEEEEEEEEEEEEEEEEEEEE1
1EEEEEEEEEEEEEEEEEEEEEEEEEEE1
1EEEEEEEEEEEEEEEEEEEEEEEEEEE1
1EEEEEEEEEEEEEEEEEEEEEEEEEEE1
1EEEEEEEEEEEEEEEEEEEEEEEEEEE1
1EEEEEEEEEEEEEEEEEEEEEEEEEEE1
1EEEEEEEEEEEEEEEEEEEEEEEEEEE1
1EEEEEEEEEEEEEEEEEEEEEEEEEEE1
1EEEEEEEEEEEEEEEEEEEEEEEEEEE1
1EEEEEEEEEEEEEEEEEEEEEEEEEEE1
1EEEEEEEEEEEEEEEEEEEEEEEEEEE1
11111111111111111111111111111