111111111111111111111
1E100000C000001E00001
100011111111101010101
10111C00000010101X101
101E11110110001011101
1010000001110110000E1
101011111101011110111
100010100000001000001
101010111101101010101
10100010100E101110101
1C10101010101000001E1
1111101010C0111111111
1P1C100011111E10000C1
101011100000001011111
10101E11111110101C101
101010001000101010101
101010100010100000001
100000111110111101111
1111101C110001C101111
1000000001110000000E1
111111111111111111111