11111111111111111111111111111111111111111
1P10001C000000E000010000010000000000000C1
10101011111011111010111111111011101111111
10001010000010C000001C000000001000000C1C1
11101110111110111011111011101110101111101
101000101010000010E0001C00101000100010001
10101111101011111010111110101011101011101
10100E101C0000001010001010101000101000001
10111010101110101111101010101010111010101
10E00000100010101010000000101010100010101
10101110101110111010111010111010111110101
101C0010000010001000101010000010100000101
10111011111111101010101111101111111011101
10001010101C000010101000001010001C0000101
10111110101111101110111011111011111111101
1E0000100E1C0000E010000000100010001010C01
11101010111111101110111111101110101010111
1C0010000010C01000101010100000E0101010001
11111010111010111111101011101111101011101
1000001000101010101010C010000010100010001
11101011101110101010101110111110111111101
1C101000101000001010000000001000100010001
10101011101011101010111011111110111010111
1000101000000010001000101010000E001010001
11111111101111111010101110101011101010101
1E100000001000000010100010101000101010101
11111010101111111110111110111110111010111
10000010101000000E00100010001010000000C01
11111110101110111010101110111010101111101
1010001010100010001010001C000000101010001
10111010101011111110111011101111101011111
10C01010101010000010000C10000C1000000E001
11101011101110111111101010101111111011111
100000101000100010E0001000101010000000101
10111110101111101111101111101011101110101
100010001010101C00001010C0000010000010101
11101010111010101110101011111111111011101
1C10101010001000100010100010000000E000001
10101010101011101011101011101110111010101
10000010E010000010CE0010100010000010101X1
11111111111111111111111111111111111111111
