11111111
1P0011C1
10100001
10111101
1C100001
11101101
1CC011X1
11111111