1111111111
1PCCCCCCX1
1101111111
1E000000E1
1111111111