1111111111111
100100C000IC1
1C00011111001
1P0011E0000X1
1111111111111