1111111111111
10010XC0000C1
1C00011111001
1P0011ES00001
1111111111111