1111111111111111111111111111111111
1P10000100000000010000100001000001
1000010111111001010000111011000011
1011110100001001010000001110001001
1000010100001100011101100010011001
1011110001000000010001000011110001
1010000101111111110001001000100011
1011100100000000010001011000101001
1010000111111111011011010011101001
1010100000000001001010010010001111
101111110001000100101011X010000001
1000000111110101000010011111110101
1000100100010101011111111000000001
1111100110010101110000000001001001
1E00000000000100000110001001001CX1
1111111111111111111111111111111111