1111111111111111111
1000000000000001111
1001011111000001111
1001000000000P01111
1001000000000E01111
10001111101100000X1
1111111111111111111