1111111111111
1001000000E01
1000011111001
1P0011X000001
1111111111111