1111111111111
1X00C0000C001
1011110000001
1010001111001
1010E000P1001
1111111111111