1111111111111
1X00C0010C001
1011100100001
1010001111001
10100000P1001
1111111111111