1111111111111
1X1000000C001
1110000000001
1000000000001
10000000P0001
1111111111111