11111111111111111111
10000000C00000011111
1001011111000001111
10010000C0000P011111
1001000000000E011111
1X001111101100000C11
11111111111111111111