111111111
1P00000E1
101111101
101C00001
101011111
1E00000C1
111011111
1C00000X1
111111111
