11111
1PCX1
11111
1E111
111E1
10001
11111