111111111111111111111
101C100010101C0000001
101P101E1010111011101
100010100000001C100E1
101110111011101110101
100000000000000000101
101010111110111111101
1010101C1000000010001
101010101010111011101
101010E0001E1000101C1
111011101111101110111
10E000100000001E10001
101110111110111010101
1010101C100E100000101
101011101010101011101
10000010001000101C001
111110111111101111111
1E0000100010001010001
101010101010111010101
1C1X101C100E000000001
111111111111111111111