11111111111
100E0000001
11101111111
1C001E00001
1011111C101
101P00CC101
10111111101
1000001C001
10111E11101
1X100000001
11111111111
